111111111111
1EP010C01CC1
11100C100001
1C11111111C1
1000C1C0C101
1C010C010001
111111111111