11111111111
1E0P1CCC111
1C0CCC1CCC1
1C1111100C1
1C1CCC1CCC1
1CCC1CCC111
11111111111