111111111111111
10000100C1000C1
1C11000111C1011
111C011E1C10001
10C100000000101
101001110101001
10001C000C1C011
111111111111111