111111111111
1C10C0C0C1C1
10001P10C001
1C10CEC01C11
10001C10C001
1C10C0C0C1C1
111111111111