111111111111111
1E0PC00000C0001
100000100011C01
101111100111101
1010C01000C1101
1C0001000110001
100000C0000C001
111111111111111