11111111111111111111111111111111111111
1E0PC00000C00011101100000100011C011101
100000100011C011101100000100011C011101
1011111001111011101100000100011C011101
1010C01000C11011101100000100011C011101
1C00010001100011101100000000011C011101
100000C0000C0011101100000100011C011101
1011111001111011101100000100000C011101
1010C01000C11011101100000100011C011101
1C00010001100011101100000100011C011101
100000C0000C0011100000000100011C011101
1011111001111000001100000100011C011101
1010C01000C11011101100000100011C011101
1C00010001100011101100000100011C011101
100000C0000C0011101100000100011C011101
1010C01000C11011101100000100011C011101
1C00010001100011101100000100011C011101
100000C0000C0011101100000100011C011101
1011111001111011101100000100011C011101
11111111111111111111111111111111111111